Bring - приносить
Sorrow - горе
Hypocrit - лицемер
Challenge round - время угадывать
You've got to be messing with me- ты должен возиться со мной 
Honestly - честно 
You said this one would be hard - вы сказали этот раз будет сложным 
We'll close up - мы заканчиваем 
You kept him alive - ты сохранил ему жизнь 
Brain stem - ствол мозга 
Impinging - столкновение 
Medulla - мозговое вещество 
Slow down- помедленнее, замедлитесь 
Organ harvest - забор органов 
 Prematurely - преждевременно 
Prepped - подготовленный 
Craniotomy - трепанация черепа 
It's been hardened - это повышенной твёрдости 
Leeched - пиявка 
Directly - прямо 
Rapid - стремительный 
Onset - начало 
Shutdown - неисправность
Still - все ещё
Image - изображение 
Guidance - руководство 
Freehand - от руки 
Showing off - хвастаться 
Intact - нетронутый 
Cover - крышка
Humiliate - унижать 
Opinion - мнение 
Reason - причина 
on call - по вызову
Difference  - разница
Such - такую
Butcher shop - мясная лавка
Fusing transected - соединить разделённое 
Fame - слава
Have to stick - должны придерживаться 
Implict - скрытый 
Disgust - отвращение 
Explicit - явный 
Glad - радостный
Invented - изобретенный 
Regardless - несмотря ни на что 
Flattered - польщен 
Another - другой
Engagement - помолвка 
Another speaking engagement - другое выступление
Chopper - вертолёт
Took - взять 
Bones - кости
Pin - игла 
Multiple torn ligaments - множественные разрывы связок 
Multiple - несколько 
Torn - разорванные 
Ruined - разрушенный 
Until - до 
Tissues - ткани
Pass - ввести 
Possible - возможно 
Expensive  - дорогой 
Wheelchair- инвалидная коляска 
Arrogant - высокомерный 
Worth it - стоит того
Research- исследования 
Realize - понимать
Consider- учитывать 
Stem - корень
Cells - клетки 
Harvesting them - собирают их 
Loan - заем 
Spent - потраченный
Meaning- значение 
Apologies  - извинения 
Pity - жалость
Barely - едва 
Sob story - печальная история 
Poor - бедный 
Charity - благотворительность 
Dreg - отброс
Patch up - заделывать 
Humming - напевая 
Competition - соревнования
Refuse - отказаться 
Untreatable - неизлечимый 
No glory for you - не благодаря тебе 
Sat - сидел 
Sacred - священный 
Carried - унесённый 
Mountaintop- вершина горы 
Elevated - приподнялся(вознесся)
Chose - выбрал 
Settle - решить 
Miracle - чудо 
Sanctuary - Святилище 
Convinced- убежденный 
Suggesting - предложенный 
Reattach - снова прикреплённый 
Edge - край 
Treatment - уход
Quite - довольно
Sorts of way - виды способов 
Governing medical board - управляющая медицинская комиссия
Figured out - разобрался 
Reorient - переориентировать 
Gift shops - сувенирная лавка 
Each - каждый 
Drawn up - составленный 
Whole - весь
Widen - расширить
Reject - отклонять 
Possibility - возможность
Speck - пятнышко, пылинка 
Indifferent - безразличной 
Dimension - измерение
Heart rate - частота сердцебиения
Beyond - вне 
Reach - достигать
Senses - чувства 
Root - корень
Existence - существование 
Matter - материя 
Thought - мысль
Infinite number - бесконечное количество 
Benevolent - доброжелательный 
Filled - заполненный 
Malice - злоба 
Lie ravenous - лежать голодным 
Vast - огромный 
Cast - бросать 
Doorstep - порог 
Stubbornness - упрямство 
Lead - вести 
Gifted - одаренный 
Law - закон 
Above - выше 
Stolen - украденный 
Decipher - расшифровывать 
Perhaps - возможно
Bathe - купаться 
Savage - дикарь 
Sorcerers - колдуны 
Antiquity - древность 
Spell - заклинание 
Offends - оскорбляет 
Sensibility - восприятие 
Harness - обуздать 
Conjure - колдовать 
Shield - щит
Even - даже 
Waving - размахивая 
Discretion of - усмотрение 
Fluent English  - беглый английский 
Forbidden - запрещённый 
Certain - определённый 
Advanced - продвинутый 
Former - бывший 
Strung up - подвесить 
Relieved - освободить от чего-то 
Left the compound - покинуть комплекс 
Overdue - просроченный 
Late fees - штрафы за просрочку платежа
Maiming - калечащий 
Horrifying - ужасающий 
Threat - угроза 
Upon - на, по 
Receive - получить 
Betrayed - предать 
Essential - существенно 
Allow - позволять 
Destiny - судьба 
Destination  - место назначения 
Gateway - ворота 
Submission - подчинение 
Surrender to its current - сдаться своему настоящему 
Sense - смысл 
Suffering - страдания 
Shall - должны 
Begged - умолял 
Preferring - предпочитая 
Blindly - слепо 
Sorcery - колдовство 
Ever present - всегда присутствует 
Undetected - незамеченный 
Affect - оказывать воздействие 
Surveil - наблюдение 
Contain - содержать 
Include - включать 
Steadfast - стойкий 
Unpredictable  - непредсказуемый 
Merciless - безжалостный 
Kind - добрый 
Grieving - скорбящий 
Headstrong - упрямый 
Disciples - ученики 
Seduced - соблазнил 
Sustain - поддерживать 
Strain - напряжение
Depended - зависит
Eternal  - вечный 
Tampering - подделка 
Probability  - вероятность 
Performing - выполнение 
Branch - ветвь 
Unstable - нестабильный 
Spatial - пространственный 
Reliving - переживание 
Same - такой же
Curiosity - любопытство 
Litany of - перечисления 
Recklessly - безрассудно 
Borrowed - заимствованный 
Dwells - обитает 
Conqueror - завоеватель 
Quest to invade - стремление вторгнуться 
Judge - судить
Perishes - погибает 
Gain out - получить 
Ought - должен 
Insult - оскорблять 
Seek - искать 
Intent of the all evolution - цель всей эволюции 
Enlightenment - просветление 
Instead - вместо 
Parlor tricks - дешёвые трюки 
Wonder - удивляться 
Overthrow - свергнуть 
Tear down - срывать 
Prayer room - молитвенная комната
Secured - обезопасить 
Falcon - сокол
Missed - пропустил 
Mess - беспорядок 
Regret - сожалеть 
Bravery - храбрость 
Celebrate - празднование 
Valor - доблесть 
Look closely - посмотрите внимательно 
Concrete - конкретный 
Gesture - жест 
Gratitude  - благодарность 
Offer - предложение 
Favor - услуга 
Care - забота 
Sake - ради 
Rip it off - сорвать это 
Strict - строго 
Hurt - повредить 
Reassuring - обнадеживающий 
Ment to find - хотел найти 
Explain - объяснять 
You will shit - вы обосретесь(вы офигеете)
Suppose - предполагать 
Step to far - зайти слишком далеко 
Sin - грех 
Spill - проливать 
Stomach - желудок 
Violence - насилие 
Literally - буквально 
Projectile - снаряд 
Witness - свидетель 
Unpleasantness - неприятность 
Due to - из-за 
Found out - выяснил 
Dining room - столовая 
Thankful - благодарный 
Since - с , так как 
Occasion - повод 
Decanter - графин 
Outstanding - выдающийся 
He will be sorely missed - его будет очень не хватать 
Selection - выбрать 
Replacement - замена 
Propose - предлагать 
Investigating - расследование 
Mercenaries - наёмники 
Glasses - очки 
Supply - поставлять 
Guerilla - партизан 
Insurgent - повстанцы 
Turn - повернуться 
Indisputably - бесспорно 
Trace - след 
Any kind - любой 
Track - отслеживать 
Property - свойство (дом, имущество) 
Surveillance - наблюдение
Aware - осведомленный 
Kidnapping - похищение 
Effected a - совершить 
Executed - казнён 
Rescue - спасать 
Which - который 
Doomsayer - предсказатель судьбы 
Expounds - излагает 
Curios - любопытный 
Actually - на самом деле
Membership - членство 
Proposal - предложение
Pick - выбирать 
Suitable - подходящий 
Evolving - развивающийся 
Remains - останки 
Entirely - полностью 
Foreign - чуждый 
Exactly - точно 
Weak chins - слабые подбородки 
Treats - лечит 
Self-esteem - самооценка 
Fit - соответствовать 
Offense - оскорбление 
Mental - психический 
Pretend - притвориться 
Chat shit - болтать дерьмо 
Guvnor - хозяин 
Banging - стучать 
Pretty much - довольно много 
Outstayed - просроченный 
Mug - кружка (сленг рожа, морда)
Nick his car - взломать его машину 
I swear - я клянусь 
Wanker  - дрочер 
Vermin - паразит 
Honor - честь 
Amongst - честь 
Thieves - воры 
Exercise - упражнение
Creek - ручей 
Lift - поднимать 
Tailor - портной 
Posted - опубликовано 
Classified - секретно 
Courage - храбрость 
Cost - расход 
Owe - быть должным 
Bitterly - горько
Disappointed - расстроенный 
Huge -  огромный 
Petty - мелкий 
Coach - тренер 
Pegged -  привязанный 
Grow up - расти 
Blame - обвинять 
Halfway - наполовину 
Fodder - корм 
Cannon - пушка 
Judging  - судить 
Ivory - слоновая кость 
Spoon - ложка 
Arses - ослы 
Piss - моча 
Simply - просто 
Fair - справедливый 
Rather -  скорее 
Appreciate - ценить 
Enormously - чрезвычайно 
Rent - арендовать 
Corner - угол 
Maketh - делает 
Let off - отпускать 
Steam - пар 
Exception - исключение 
Premired - премьера 
Rise - рост
Expected - ожидал 
Award - награда 
Notable - заметный 
Absence - отсутствие 
Carpet - ковёр 
Appear - появляться 
Failed - неуспешный
Ransom - выкуп 
Demanded - потребовал 
Geezer - старик 
Notice - уведомление 
Evidence - доказательство 
Activities - деятельность
Deliver - доставлять 
Appropriate - соответствующий
Authorities - власти 
Maggot - личинка 
Potential - потенциал 
Loyal - лояльный 
Lack - недостаток 
Path - путь 
Prepare - подготовить 
Opportunity - возможность 
Individuals -  лица 
Heir  - наследие 
Meant  - иметь в виду 
Uninherited  - ненаследственный 
Desire - желание 
Preserve - сохранять 
Protect -  защищать 
Founders - основатели 
Wealth - богатство 
Influence - влияние 
Other - другой 
Venture - риск 
Independent - независимый
Intelligence agency - спецслужба 
Undermine - подрывать 
Integrity -  честность 
Government - правительство 
Government-run - управляемый государством 
Late again - опять поздно  
Fall in - в строй 
Embark - садиться 
Probably - вероятно 
Kin  - родственник
Represent - представлять 
Acknowledgment - подтверждение 
Agreement - согласие 
Incidentally - между прочим 
Break - перерыв 
Fall out - вольно 
Conversation  - беседа 
Neither - ни один 
Definitely - определённо 
Cheers - ваше здоровье 
Shame - стыд 
Issue - проблема 
Retired - ушедший на пенсию 
Straight - прямой 
Lobbying - лоббирование
Hence - следовательно 
Epiphany - богоявление 
Solve - решать 
Buried - похороненный 
Sand - песок 
Reelection - переизбрание 
Ears - уши 
Calm - спокойствие 
Loo - туалет 
Snorkels - трубка 
Shower heads - душевая лейка
Hang - вешать 
Breathing - дыхание 
Tube  - трубка 
Bend - сгиб 
Spotting - обнаружение 
Wipe  - вытирать 
Smirks -  ухмыляться 
Concerned - обеспокоенный 
Fascinating - очаровательно 
Goddamn - проклятый 
Emergency  - чрезвычайная ситуация 
All over - повсюду 
Spoke - говорил 
Insist - настаивать 
Freaky - причудливый 
Recognizable - узнаваемый 
Forward - вперёд 
Paramount - первостепенный 
Enhance - усиливать 
Breed - порода 
Concussion - сотрясение 
Exposed - незащищённый 
Footage - отснятый материал 
Encrypted - зашифрованный 
Uncrackable - невзламыыаемый 
Sharing - обмен 
Patience - терпение 
Bollocks - чушь 
Mate - приятель 
Thrown - брошенный 
Pleb - плебей 
Lingering - затяжной 
Flush - румянец 
Just won't flush -  просто не смывается 
Grade - оценка 
Educated - образованный 
Both - оба 
Completely - полностью 
Speechless - безмолвный 
Inspirational  - вдохновляющий 
Galvanize the people - воодушевлять людей 
Ensure - гарантировать 
Harm - вред 
Hardly felt - почти не почувствовал 
When I'm casing place rob - когда я граблю место 
Dismissed - уволен 
Observe  - наблюдать 
Rank - отвратительно 
Blew up - взорвал 
Explosion - взрыв 
Neck - шея 
Scar  - шрам 
Hardware - аппаратное обеспечение 
Fortunately - к счастью 
Employees  - сотрудники 
Worldwide - мировой 
Announcement  - объявление
Average - средний 
Vehicle - транспортное средство 
Elaborate  - разрабатывать 
Assertive  - напористый
Armed - вооружённый 
Pillow - подушка 
Loud - громкий 
Band-aid - пластырь 
Rip - рвать 
Rigamarole - вздор 
Overstep - перешагивать
Boundes - границы
Waste - напрасно тратить
Bunch of - куча 
Bumping - натыкаясь 
Dump - свалка 
Piece - кусок 
Crap - дерьмо 
Crap out - обосрать 
Stakes - ставки 
Crucial - ключевой 
Dumber - глупее
Necessary - необходимый
Kind of - вроде 
Errand  - поручение 
Pair  - пара
Geez - блин 
Obvious - очевидно 
Swing - качать 
Incredibly - невероятно 
Urgent - срочный 
Involves - включает в себя
Surgery - операция 
Rehash - перефразировать 
Nursing - уход за больными 
Pitch - подача 
Seed - семя 
Anxiety - беспокойство 
Intimidating  - пугающий 
Surrounding - окружающий 
Lumbering - неуклюжий 
Defies - бросает вызов 
Stumbled - спотыкаться
Slay - убить
Workflow - рабочий процесс
Weird - странный 
Dialed - набранный 
Wish - желание 
Join - присоединиться 
Jammed up - застрял 
Off the grid - вне сети
Grid - сетка
Bunch - связка 
Stuff - вещи 
Darn - штопать 
Darn it to heck - черт возьми 
Thing - вещи 
Hung up the spurs - повесить шпоры
Pending - в ожидании 
Keep - держать 
Excited - взволнованный 
Announcement  - объявление 
Figure out - понимать
Thriving - процветающий 
Unrelated - несвязанный
Unfortunately - к сожалению 
Crunch - хруст
Essence - сущность 
Time is of the essence - время имеет существенное значение 
Reported - сообщил 
Duty - долг 
Promotion - повышение
Least - наименее 
Get shit-canned - получать дерьмовые консервы 
Cheer - радость 
Get-together - собираться 
Together - вместе
Wig - парик 
Sucks - отстой 
Committed - преданный идее
Admit - признавать 
Less - меньше 
Rollerblade - ролики 
Equity - беспристрастный 
Desperate - отчаянный 
Have no other options left - других вариантов не осталось 
Declined - отклоненный 
Tied down - привязанный 
Climbed - поднялся 
Bat - летучая мышь 
Throw - бросить 
Shatter - разбить 
Regret - сожалеть 
Gapped - разорвать 
Swashbuckle - головорез 
Excuses - оправдания 
Commit - совершить 
Fiancee - невеста 
Guess - предполагать 
Odd - странный 
Lean - наклонять 
Leaning towards - склоняется к 
Fridge - холодильник
Upsetting - расстраивающий 
Blow - дуть 
Consciousness  - сознание 
External - внешний 
Embrace - объятия 
Gobble - сожрать 
Excrete - выделять 
Excrete the waste - выделять отходы
Molehill - кротовина 
Bored - скучающий 
Most - большинство 
Ennui - скука 
Summon - вызвать 
Covenant - завет 
Dicey - рискованный 
Assume - предполагать 
Chapped - потрескавшийся 
Marched - маршировал 
Upstairs - вверх по лестнице 
Douche - душ 
Preaching - проповедь 
Choir - церковь
Attitude - отношения 
Right out - сразу 
Gate - ворота
Both - оба 
Grew - вырос 
Shelve - полка 
Handsome - одинокий 
Dating - встречаться 
Release - выпускать 
Stumped - тупик 
Baffled - сбитый с толка 
Ridiculous  - нелепо 
Netherworld - преисподняя 
Rad - рад 
Band - группа 
Snap - щелчок 
Spit - плевок 
Shrug - пожимание плечами 
Whatevs - что нибудь 
Erase - стереть 
Booty - добыча 
Whore - шлюха 
Gig - концерт 
Jogging - беглый трусцой 
Loop - петля 
Shelter - приют 
Fooled - одураченный 
Smothe - задушить 
Soon  - скоро 
Nurse - медсестра 
Raves - рейвы 
Off the hook - сорваться с крючка 
Necklace - ожерелье 
Astounded - изумленный 
Frustrating -  раздражающий 
Grab - схватить 
Rough - грубый 
Warn - предупреждать 8ки
Trim - подрезать 
Bridal shower - девичник 
Dip - окунать 
Tons - тонн 
Coffers - казна 
Purpose - цель 
Computing - вычисления
Insight - понимание 
Penned - записал 
Digital - цифровой 
Infancy - младенчество 
Maintenance  - обслуживание 
Mammoth - мамонт 
Acknowledgment  - подтверждение 
Distillation - дистиляция 
Worth - ценность 
Article  - статья 
Reflect - отражение 
Contribute - способствовать 
Clarification  - уточнение 
Explanation - объяснение
Particular  - особый 
Folk  - народный 
Provided - предоставил 
Introduction  - введение 
Shape - форма 
Aid - помогать 
Rang - звонил 
Retouching  - ретушь 
Diverse - разнообразный 
Outward - наружу 
Amazingly  - удивительно 
Similar  - похоже 
Rely - полагаться 
Repertoire  - репертуар 
Enable - давать возможность 
Commonly - обычно 
Square - квадрат 
Sliver of - кусочек 
Etched  - выгравированный 
Network - сеть 
Circuitry - схема 
Cracking  - взламывая 
Remote  - удалённый 
Television remote - пульт от телевизора 
Thorough  - тщательный 
Grasp -  понять 
Underlie - лежать в основе 
Aforementioned  - вышеупомянутый 
Brake - тормоз 
Bills - счета 
Revenue - доход 
Chapter - глава 
Straightforward - простой 
Framework -  рамки 
Covered - покрытый 
In the rest - в остальном 
Newcomers - новички 
Encourage - поощрять 
Furnish - снабжать 
Nutshell  - в двух словах 
Stream - транслировать 
Produce - производить 
Initial -  исходный 
Generalize - обобщать 
Consist - состоять 
Operate - действовать 
Addition - добавление 
Subtraction  - вычитание 
And so on - и так далее 
However - однако 
Depicted  - изображен 
Sequence - последовательность 
Describe  - описывать 
Intuitively - интуитивно 
Pocket - карман 
Spreadsheet - электронная таблица 
File-clerk - архив,делопроизводитель 
Respect - уважение 
Definition - определение 
Shuffle - перемешивать 
Accord - согласие 
Set  - набор 
Prior - прежний 
Reset - перезагрузить 
Met - встретил 
Halt - останавливаться 
We might - мы можем 
Opposed - против 
Accessed  - доступ 
Store - магазин 
Sequentially - последовательно
Altering - изменение 
Achieve  - достигать 
Strike - ударять 
Emphasize  - подчёркивать 
Recognize - узнавать 
Preceding - предшествующий 
Description - описание 
Reduced - уменьшенный 
Traversing   - пересекая 
Linear - линейный 
Tape - лента 
Apply - применять 
Environmental   - относящийся к окружающей среде 
Snapshot - снимок 
Indeed - действительно 
Inherent - присущий 
Onto - на 
Increase - увеличивать 
Storage - хранилище 
Implies - подразумевает 
Similarly  - похожим образом 
Via - с помощью 
Arriving - прибытие 
Depiction - описание 
Misleading - вводящий в заблуждение 
Specify - указать 
In order - чтобы 
Transmitting - передача
Required  - необходимый 
Thuse - таким образом 
By means - посредством 
Shuttling - челночный
Around  - вокруг 
Shuttling numbers - обмена номерами 
Arrive - приезжать 
Make up the - составляют 
As the - как 
Into - в
Expand  - расширить 
One might - можно было бы 
Prerecorded - предварительно записанный 
Fed - кормили 
Manual - руководство 
Stored - хранится 
Just such - именно такой 
Separate  - отдельный 
Ability - способность 
Reuse - повторное использование 
Different  - другой 
Invention - изобретение 
Abacus - счёты 
Flexibility  - гибкость 
Usefulness - полезность 
Apart - отдельно 
Capabilities  - возможности 
Speech - речь
Vowels - гласные
Demolition  - снос 
Front-row - передний ряд
Wrapped - завернутый 
Foundation - фундамент 
Issuing - выпуск 
Issuing orders - приказы 
Often - часто 
Toward - к 
Rebels - повстанцы 
Taken over - захвачен 
Dragging - перетаскивание 
Boat - лодка 
Attach - прикреплённый 
Harbor  - гавань 
Troop - отряд 
Royal - королевский 
Navy - военно-морской 
Across - через 
Fleet - флот 
Disembark - высаживаться 
Besieging - осаждающий 
Regiment - полк 
Trade - торговля
Hire - нанимать 
Infantry - пехота 
Sufficient  - достаточный 
Excel - превосходить 
Combat - бой 
Exploration - исследование 
Cheaper - более дешёвый 
Ferry - перевозить 
Improvement  - улучшение 
Vary - отличаться 
Vital - жизненно-важный 
Categorized - классифицированный 
Replace - заменять 
Taxation -  налогообложение 
Queue - очередь 
Either - или 
Simultaneously   - одновременно 
Amount - количество 
Regard -  внимание 
Benefit - выгода 
Conclude - заключить 
Justification - оправдание 
Casus belli - повод для войны 
Sue for - предъявлять иск 
Merge - сливаться 
Tribute  - дань
Claim - требовать 
Truce - перемирие 
Expire - истекает 
Hovering - парящий 
Incur - нести 
Penalty - штраф
Establishing - установление 
Growth - рост 
Manpower - рабочая сила 
Per - за 
Drain - осушать 
Casualties - жертвы 
Unrest - беспорядки 
Tab - вкладка 
Ruler - линейка 
Unity - единство 
Decreased  - уменьшился 
Ahead - предстоящий 
Gain - прирост 
Legitimacy - легитимность 
Republic - Республика 
Projection - проекция 
Flex - сгибаться 
Muscle - мышца 
Rival - соперник 
Embargoing - эмбарго 
Envoys - посланники 
Merchant - торговец 
Steer - управлять 
Depend - зависеть 
Advisor - советник 
Hide - скрывать 
Elector - выборщик 
Papacy - папство 
Spend - тратить 
Divide -  разделять 
Comparison - сравнение 
Ledger - бухгалтерская книга 
Border - граница 
Belong - принадлежать 
Direction  - направление 
Roman - римский 
Core - основной 
Allie - союзник  
Stripe - полоса 
Node - узел 
Float - плавать 
Buoy - буй 
Portion - часть 
River estuary  - устье реки 
Determine  - определять 
Collect - собирать
Compare - сравнивать 
Competitor - конкурент
Record - записывать 
Naval - военно-морской 
Decide - решать 
Boost -  способствовать росту 
Salaries - зарплата 
Inflation - инфляция 
Significantly  - существенно 
Recently - недавно 
Plots - участки 
Marriage - свадьба 
Bond - связь 
Union - союз 
Decision  - решение 
Requirement - требование 
Fulfilled  - выполненный 
Enact - принимать 
Immediately  - немедленно 
Spread - распространение 
Choose - выбирать 
Plenty - множество 
Discover - обнаружить 
Settlement - урегулирование 
Uncharted - неизведанный 
Assign - назначать 
Led - вёл 
Attrition - потёртости 
Cage -  клетка 
Capture - захватывать 
Fought - дрался 
Lay - класть 
Prophecy - пророчество 
Defenseless - беззащитный 
Bust out - вспыхнуть 
Silly - глупый 
Smouldering - тлеющий 
Rubble - щебень 
Half - половина 
Accomplish  - выполнить 
Suddenly - внезапно 
Moosie  - лось 
Slobbering  - слюнявый 
Pec - грудная клетка 
Sweat - пот 
Insomnia - бессонница 
Ramps up - нарастает 
Cornflower  - Василек 
Tie - галстук 
Deprioritize - лишить приоритета 
Advise - советовать 
Snag - загвоздка 
Pep - бодрость духа 
Grande - большой 
Enema - клизма 
Nest - гнездо 
Dust - пыль 
Ruffle - рябь 
Exerbike - велотренажёр 
Wire - проволока 
Bleach - отбеливать 
Through - через 
Dishes - тарелки 
Imperfections  -  недостатки 
Indigenous  - местный 
Nod - кивок 
Lighten up - облегчить 
Swing by - пролететь мимо 
Deserve - заслуживать 
Ourselves up -  себя 
Tears - слезы 
Knees - колени 
Awkward - неуклюжий 
Chest -  грудь 
Juicer - соковыжималка 
Divorce - развод 
Grown - вырос 
Rubbery - резиновый 
Oblivion -  забвение 
Addict - наркоман 
Worst - худший 
Warm - тёплый 
Crowded - переполненный 
Cave -  пещера 
Resurrected - воскресший 
Vacation - отпуск 
Chick - цыплёнок 
Liar - лжец 
Diseases - болезни 
Guide - гид 
Guided - управляемый 
Asleep - спящий 
Get laid - трахаться 
Entrance - вход 
Tumor - опухоль 
Scratch - царапать 
Heal - лечить 
Tonguing - язык 
Candystripe - конфеты 
Ward - сторожить 
Bowel - кишечник 
Switch - выключатель 
Butter -  масло 
Kit - набор 
Takeoff -  снимать 
Landing - посадка 
Infant - младенец 
Ashtray - пепельница 
Trapped - в ловушке 
Field - поле 
Failure - отказ
Out-of-cort - внесудебный 
The plane banked - самолёт накренился 
Sharply - резко 
Midair - в воздухе 
Insurance  - страхование 
Unable -  не могущий 
Unwilling - нежелающий 
Listed - перечислены 
Docile - послушание 
Fate - судьба 
Blank -  пустой 
Sick - больной 
Yardstick - измерительная линейка 
Gasoline - бензин 
Inclined - наклонный 
Etiquette  - этикет 
Luggage  - багаж 
Razor - бритва 
Imply - подразумевать 
Solid -  твёрдый 
Blast - взрыв 
Debris - обломки 
Sails - паруса 
Embarrassing - смущаюший 
Condiment - приправа 
Feet - ноги 
Ceiling - потолок 
Worse - худший 
Toss - бросать 
Decent - приличный 
Wardrobe - гардероб 
Duvet - одеяло 
Blanket - одеяло 
Hunter-gutherer - охотник-собиратель 
Consum - потреблять 
Obsession  -  одержимость 
Poverty - бедность 
Polishing  - полировка 
Brass - латунь 
Evolve - эволюционировать 
Chips fall - фишки падают 
Versatile  - универсальный 
Pitcher - кувшин 
Foreplay - прелюдия 
Reel - катушка 
Cue for - сигнал доя 
Afford - предоставлять 
Splicing - соединение 
Snooty - высокомерный 
Contribution  - вклад 
Seasoning - приправа 
Bisque -  суп 
Farted - пукнул 
Meringues - безе
Boarded up - заколоченный 
Kick - пинать 
Collapse - крах 
Warehouse - склад 
Mill - мельница 
Stale -  несвежий 
Trickle - струйка 
Plaster - штукатурка 
Fixtures  - светильники 
Swelled - опухший 
Shrank - сжался 
Rust - ржавчина 
Nails - гвозди 
Elbow - локоть 
Previous - предыдущий 
Graduate - выпускник 
Condo - квартира 
Premise - помещение 
Efficient - эффективный 
Thief - вор
Swallow - глотать 
Struggle -  борьба
Quite - тихий 
Quntized fields - квантовые поля 
Feeble - слабый 
Comprehend - постигать 
Excitable - волнительный, возбудимый 
Aloof - в стороне 
Spark - искра 
Witty - остроумно 
Make a trade - совершить сделку 
Warning - предупреждение 
Alarm clock - будильник 
Permissive - снисходительный 
Conversion - преобразование 
Ambiguity - двусмысленность 
Declaration - декларация 
Parentheses - круглые скобки 
Disambiguation  - устранение неоднозначности 
Divisible - делимый 
Worry - волноваться 
Aging - старение 
Currency - валюта 
Earn - зарабатывать 
The rest of us - остальные из нас 
Hurry - спешка 
Extra - дополнительный 
On the side - на стороне 
Garment - одежда 
Garment district - швейный район
Reminisce  - вспоминать 
Shift - смена 
Gamble - азартная игра 
Immortal - бессмертный 
Few - немного
The cost - цена 
Keeps rising - продолжает расти 
Keep dying - продолжали умирать 
Letting - сдача 
Circulation  - обращение 
Suspicious  - подозрительный 
Behavior  - поведение 
Conscious  - сознательный 
Habit - привычка 
Match - соответствовать 
Pleasure  - удовольствие 
Inheritance  - наследование 
Bet - делать ставку 
Knowing - зная 
Act - действовать 
Unfair - несправедливы 
Fittest - сильнейший 
Raise - поднимать  
Merely - просто 
Figures - цифры 
Confusing - сбивать с толку 
Mother-in-law - свекровь 
Doubt - сомневаться 
Envy - завидовать 
Foolish - глупый 
Courageous  -  смелый 
Damn - проклятие 
Insane - безумный 
Justice - справедливость 
Measure - мера 
Held - держать 
Will be held - будет проходить 
Processing - обработка 
Booking - бронирование 
Arrange - договариваться 
Gorgeous  - великолепный 
Devide - разделить 
Share - делиться 
Diem - день 
Wire me my per diem - телеграфируйте мне мои суточные 
Afraid - испуганный 
Spare - запасной 
Dissappoint  - разочаровать 
Repossession - возвращение во владение 
Spreed - распространение 
Hostage - заложник 
Regrettable - достойный сожаления 
Vigilance - бдительность 
Warrant - ордер 
Arrangement -  договорённость 
Withdrew - снял 
Suffocating -  удушающий 
Reward - награда
Catch - ловить 
Willing - готовый 
Overlook - игнорировать 
Boundaries  - границы
Give up - сдаться 
Bribe - взятка
Seldom - редко 
Humble - скромный 
Fellas - ребята 
Permit - разрешать 
Traumatized  - травмированный 
Route - маршрут 
Frequency  - частота 
Busted-up - разоренный 
Sulfur - сера 
Heck - черт 
Residue - остаток 
Mortal - смертный 
Possessed  - одержимый 
Barfing - рвота 
Pea - горох 
Belief - вера 
Disaster - катастрофа 
Behind - позади 
Ratchet up the body count - увеличить количество трупов 
Cockpit - кабина 
Reforged  - перекован 
Bony - костлявый 
Tramp - бродяга 
Interracial  - межрассовый 
Occur - происходить 
Devastate - опустошать 
Tone - тон 
Curse - проклинать 
Yelling - кричать 
Curb - бордюр 
Appeal - обращаться 
Digging - копать 
Dare - осмелиться 
Tight - тугой 
Waitress - официантка 
Sneaky - подлый 
Rotted - сгнил 
Drill - дрель 
You know the drill - вы знаете что делать 
Throat - горло 
Slit - щель 
Obtain - получать 
Convey - передавать 
Carry out - выполнять 
Eventually  - в конце концов 
Fetch - принести 
Actual - действительный 
Instantaneously  - мгновенно 
Consideration  - рассмотрение 
Surface - поверхность 
Constrain - ограничивать 
Stick to - придерживаться 
Relatively  - относительно