Abacus - счёты 
Ability - способность 
Above - выше 
Absence - отсутствие 
Accessed  - доступ 
Accomplish  - выполнить 
Accord - согласие 
Achieve  - достигать 
Acknowledgment  - подтверждение 
Acknowledgment - подтверждение 
Across - через 
Act - действовать 
Activities - деятельность
Actual - действительный 
Actually - на самом деле
Addict - наркоман 
Addition - добавление 
Admit - признавать 
Advanced - продвинутый 
Advise - советовать 
Advisor - советник 
Affect - оказывать воздействие 
Afford - предоставлять 
Aforementioned  - вышеупомянутый 
Afraid - испуганный 
Aging - старение 
Agreement - согласие 
Ahead - предстоящий 
Aid - помогать 
Alarm clock - будильник 
All over - повсюду 
Allie - союзник  
Allow - позволять 
Aloof - в стороне 
Altering - изменение 
Amazingly  - удивительно 
Ambiguity - двусмысленность 
Amongst - честь 
Amount - количество 
And so on - и так далее 
Announcement  - объявление 
Announcement  - объявление
Another - другой
Another speaking engagement - другое выступление
Antiquity - древность 
Anxiety - беспокойство 
Any kind - любой 
Apart - отдельно 
Apologies  - извинения 
Appeal - обращаться 
Appear - появляться 
Apply - применять 
Appreciate - ценить 
Appropriate - соответствующий
Armed - вооружённый 
Around  - вокруг 
Arrange - договариваться 
Arrangement -  договорённость 
Arrive - приезжать 
Arriving - прибытие 
Arrogant - высокомерный 
Arses - ослы 
Article  - статья 
As the - как 
Ashtray - пепельница 
Asleep - спящий 
Assertive  - напористый
Assign - назначать 
Assume - предполагать 
Astounded - изумленный 
Attach - прикреплённый 
Attitude - отношения 
Attrition - потёртости 
Authorities - власти 
Average - средний 
Award - награда 
Aware - осведомленный 
Awkward - неуклюжий 
Baffled - сбитый с толка 
Band - группа 
Band-aid - пластырь 
Banging - стучать 
Barely - едва 
Barfing - рвота 
Bat - летучая мышь 
Bathe - купаться 
Begged - умолял 
Behavior  - поведение 
Behind - позади 
Belief - вера 
Belong - принадлежать 
Bend - сгиб 
Benefit - выгода 
Benevolent - доброжелательный 
Besieging - осаждающий 
Bet - делать ставку 
Betrayed - предать 
Beyond - вне 
Bills - счета 
Bisque -  суп 
Bitterly - горько
Blame - обвинять 
Blank -  пустой 
Blanket - одеяло 
Blast - взрыв 
Bleach - отбеливать 
Blew up - взорвал 
Blindly - слепо 
Blow - дуть 
Boarded up - заколоченный 
Boat - лодка 
Bollocks - чушь 
Bond - связь 
Bones - кости
Bony - костлявый 
Booking - бронирование 
Boost -  способствовать росту 
Booty - добыча 
Border - граница 
Bored - скучающий 
Borrowed - заимствованный 
Both - оба 
Both - оба 
Boundaries  - границы
Boundes - границы
Bowel - кишечник 
Brain stem - ствол мозга 
Brake - тормоз 
Branch - ветвь 
Brass - латунь 
Bravery - храбрость 
Break - перерыв 
Breathing - дыхание 
Breed - порода 
Bribe - взятка
Bridal shower - девичник 
Bring - приносить
Bumping - натыкаясь 
Bunch - связка 
Bunch of - куча 
Buoy - буй 
Buried - похороненный 
Bust out - вспыхнуть 
Busted-up - разоренный 
Butcher shop - мясная лавка
Butter -  масло 
By means - посредством 
Cage -  клетка 
Calm - спокойствие 
Candystripe - конфеты 
Cannon - пушка 
Capabilities  - возможности 
Capture - захватывать 
Care - забота 
Carpet - ковёр 
Carried - унесённый 
Carry out - выполнять 
Cast - бросать 
Casualties - жертвы 
Casus belli - повод для войны 
Catch - ловить 
Categorized - классифицированный 
Cave -  пещера 
Ceiling - потолок 
Celebrate - празднование 
Cells - клетки 
Certain - определённый 
Challenge round - время угадывать
Chapped - потрескавшийся 
Chapter - глава 
Charity - благотворительность 
Chat shit - болтать дерьмо 
Cheaper - более дешёвый 
Cheer - радость 
Cheers - ваше здоровье 
Chest -  грудь 
Chick - цыплёнок 
Chips fall - фишки падают 
Choir - церковь
Choose - выбирать 
Chopper - вертолёт
Chose - выбрал 
Circuitry - схема 
Circulation  - обращение 
Claim - требовать 
Clarification  - уточнение 
Classified - секретно 
Climbed - поднялся 
Coach - тренер 
Cockpit - кабина 
Coffers - казна 
Collapse - крах 
Collect - собирать
Combat - бой 
Commit - совершить 
Committed - преданный идее
Commonly - обычно 
Compare - сравнивать 
Comparison - сравнение 
Competition - соревнования
Competitor - конкурент
Completely - полностью 
Comprehend - постигать 
Computing - вычисления
Concerned - обеспокоенный 
Conclude - заключить 
Concrete - конкретный 
Concussion - сотрясение 
Condiment - приправа 
Condo - квартира 
Confusing - сбивать с толку 
Conjure - колдовать 
Conqueror - завоеватель 
Conscious  - сознательный 
Consciousness  - сознание 
Consider- учитывать 
Consideration  - рассмотрение 
Consist - состоять 
Constrain - ограничивать 
Consum - потреблять 
Contain - содержать 
Contribute - способствовать 
Contribution  - вклад 
Conversation  - беседа 
Conversion - преобразование 
Convey - передавать 
Convinced- убежденный 
Core - основной 
Corner - угол 
Cornflower  - Василек 
Cost - расход 
Courage - храбрость 
Courageous  -  смелый 
Covenant - завет 
Cover - крышка
Covered - покрытый 
Cracking  - взламывая 
Craniotomy - трепанация черепа 
Crap - дерьмо 
Crap out - обосрать 
Creek - ручей 
Crowded - переполненный 
Crucial - ключевой 
Crunch - хруст
Cue for - сигнал доя 
Curb - бордюр 
Curios - любопытный 
Curiosity - любопытство 
Currency - валюта 
Curse - проклинать 
Damn - проклятие 
Dare - осмелиться 
Darn - штопать 
Darn it to heck - черт возьми 
Dating - встречаться 
Debris - обломки 
Decanter - графин 
Decent - приличный 
Decide - решать 
Decipher - расшифровывать 
Decision  - решение 
Declaration - декларация 
Declined - отклоненный 
Decreased  - уменьшился 
Defenseless - беззащитный 
Defies - бросает вызов 
Definitely - определённо 
Definition - определение 
Deliver - доставлять 
Demanded - потребовал 
Demolition  - снос 
Depend - зависеть 
Depended - зависит
Depicted  - изображен 
Depiction - описание 
Deprioritize - лишить приоритета 
Describe  - описывать 
Description - описание 
Deserve - заслуживать 
Desire - желание 
Desperate - отчаянный 
Destination  - место назначения 
Destiny - судьба 
Determine  - определять 
Devastate - опустошать 
Devide - разделить 
Dialed - набранный 
Dicey - рискованный 
Diem - день 
Difference  - разница
Different  - другой 
Digging - копать 
Digital - цифровой 
Dimension - измерение
Dining room - столовая 
Dip - окунать 
Direction  - направление 
Directly - прямо 
Disambiguation  - устранение неоднозначности 
Disappointed - расстроенный 
Disaster - катастрофа 
Disciples - ученики 
Discover - обнаружить 
Discretion of - усмотрение 
Diseases - болезни 
Disembark - высаживаться 
Disgust - отвращение 
Dishes - тарелки 
Dismissed - уволен 
Dissappoint  - разочаровать 
Distillation - дистиляция 
Diverse - разнообразный 
Divide -  разделять 
Divisible - делимый 
Divorce - развод 
Docile - послушание 
Doomsayer - предсказатель судьбы 
Doorstep - порог 
Doubt - сомневаться 
Douche - душ 
Dragging - перетаскивание 
Drain - осушать 
Drawn up - составленный 
Dreg - отброс
Drill - дрель 
Due to - из-за 
Dumber - глупее
Dump - свалка 
Dust - пыль 
Duty - долг 
Duvet - одеяло 
Dwells - обитает 
Each - каждый 
Earn - зарабатывать 
Ears - уши 
Edge - край 
Educated - образованный 
Effected a - совершить 
Efficient - эффективный 
Either - или 
Elaborate  - разрабатывать 
Elbow - локоть 
Elector - выборщик 
Elevated - приподнялся(вознесся)
Embargoing - эмбарго 
Embark - садиться 
Embarrassing - смущаюший 
Embrace - объятия 
Emergency  - чрезвычайная ситуация 
Emphasize  - подчёркивать 
Employees  - сотрудники 
Enable - давать возможность 
Enact - принимать 
Encourage - поощрять 
Encrypted - зашифрованный 
Enema - клизма 
Engagement - помолвка 
Enhance - усиливать 
Enlightenment - просветление 
Ennui - скука 
Enormously - чрезвычайно 
Ensure - гарантировать 
Entirely - полностью 
Entrance - вход 
Environmental   - относящийся к окружающей среде 
Envoys - посланники 
Envy - завидовать 
Epiphany - богоявление 
Equity - беспристрастный 
Erase - стереть 
Errand  - поручение 
Essence - сущность 
Essential - существенно 
Establishing - установление 
Etched  - выгравированный 
Eternal  - вечный 
Etiquette  - этикет 
Even - даже 
Eventually  - в конце концов 
Ever present - всегда присутствует 
Evidence - доказательство 
Evolve - эволюционировать 
Evolving - развивающийся 
Exactly - точно 
Excel - превосходить 
Exception - исключение 
Excitable - волнительный, возбудимый 
Excited - взволнованный 
Excrete - выделять 
Excrete the waste - выделять отходы
Excuses - оправдания 
Executed - казнён 
Exerbike - велотренажёр 
Exercise - упражнение
Existence - существование 
Expand  - расширить 
Expected - ожидал 
Expensive  - дорогой 
Expire - истекает 
Explain - объяснять 
Explanation - объяснение
Explicit - явный 
Exploration - исследование 
Explosion - взрыв 
Exposed - незащищённый 
Expounds - излагает 
External - внешний 
Extra - дополнительный 
Failed - неуспешный
Failure - отказ
Fair - справедливый 
Falcon - сокол
Fall in - в строй 
Fall out - вольно 
Fame - слава
Farted - пукнул 
Fascinating - очаровательно 
Fate - судьба 
Favor - услуга 
Fed - кормили 
Feeble - слабый 
Feet - ноги 
Fellas - ребята 
Ferry - перевозить 
Fetch - принести 
Few - немного
Fiancee - невеста 
Field - поле 
Figure out - понимать
Figured out - разобрался 
Figures - цифры 
File-clerk - архив,делопроизводитель 
Filled - заполненный 
Fit - соответствовать 
Fittest - сильнейший 
Fixtures  - светильники 
Flattered - польщен 
Fleet - флот 
Flex - сгибаться 
Flexibility  - гибкость 
Float - плавать 
Fluent English  - беглый английский 
Flush - румянец 
Fodder - корм 
Folk  - народный 
Fooled - одураченный 
Foolish - глупый 
Footage - отснятый материал 
Forbidden - запрещённый 
Foreign - чуждый 
Foreplay - прелюдия 
Former - бывший 
Fortunately - к счастью 
Forward - вперёд 
Fought - дрался 
Found out - выяснил 
Foundation - фундамент 
Founders - основатели 
Framework -  рамки 
Freaky - причудливый 
Freehand - от руки 
Frequency  - частота 
Fridge - холодильник
Front-row - передний ряд
Frustrating -  раздражающий 
Fulfilled  - выполненный 
Furnish - снабжать 
Fusing transected - соединить разделённое 
Gain - прирост 
Gain out - получить 
Galvanize the people - воодушевлять людей 
Gamble - азартная игра 
Gapped - разорвать 
Garment - одежда 
Garment district - швейный район
Gasoline - бензин 
Gate - ворота
Gateway - ворота 
Geez - блин 
Geezer - старик 
Generalize - обобщать 
Gesture - жест 
Get laid - трахаться 
Get shit-canned - получать дерьмовые консервы 
Get-together - собираться 
Gift shops - сувенирная лавка 
Gifted - одаренный 
Gig - концерт 
Give up - сдаться 
Glad - радостный
Glasses - очки 
Gobble - сожрать 
Goddamn - проклятый 
Gorgeous  - великолепный 
Governing medical board - управляющая медицинская комиссия
Government - правительство 
Government-run - управляемый государством 
Grab - схватить 
Grade - оценка 
Graduate - выпускник 
Grande - большой 
Grasp -  понять 
Gratitude  - благодарность 
Grew - вырос 
Grid - сетка
Grieving - скорбящий 
Grow up - расти 
Grown - вырос 
Growth - рост 
Guerilla - партизан 
Guess - предполагать 
Guidance - руководство 
Guide - гид 
Guided - управляемый 
Guvnor - хозяин 
Habit - привычка 
Half - половина 
Halfway - наполовину 
Halt - останавливаться 
Handsome - одинокий 
Hang - вешать 
Harbor  - гавань 
Hardly felt - почти не почувствовал 
Hardware - аппаратное обеспечение 
Harm - вред 
Harness - обуздать 
Harvesting them - собирают их 
Have no other options left - других вариантов не осталось 
Have to stick - должны придерживаться 
He will be sorely missed - его будет очень не хватать 
Headstrong - упрямый 
Heal - лечить 
Heart rate - частота сердцебиения
Heck - черт 
Heir  - наследие 
Held - держать 
Hence - следовательно 
Hide - скрывать 
Hire - нанимать 
Honestly - честно 
Honor - честь 
Horrifying - ужасающий 
Hostage - заложник 
Hovering - парящий 
However - однако 
Huge -  огромный 
Humble - скромный 
Humiliate - унижать 
Humming - напевая 
Hung up the spurs - повесить шпоры
Hunter-gutherer - охотник-собиратель 
Hurry - спешка 
Hurt - повредить 
Hypocrit - лицемер
I swear - я клянусь 
Image - изображение 
Immediately  - немедленно 
Immortal - бессмертный 
Imperfections  -  недостатки 
Impinging - столкновение 
Implict - скрытый 
Implies - подразумевает 
Imply - подразумевать 
Improvement  - улучшение 
In order - чтобы 
In the rest - в остальном 
Incidentally - между прочим 
Inclined - наклонный 
Include - включать 
Increase - увеличивать 
Incredibly - невероятно 
Incur - нести 
Indeed - действительно 
Independent - независимый
Indifferent - безразличной 
Indigenous  - местный 
Indisputably - бесспорно 
Individuals -  лица 
Infancy - младенчество 
Infant - младенец 
Infantry - пехота 
Infinite number - бесконечное количество 
Inflation - инфляция 
Influence - влияние 
Inherent - присущий 
Inheritance  - наследование 
Initial -  исходный 
Insane - безумный 
Insight - понимание 
Insist - настаивать 
Insomnia - бессонница 
Inspirational  - вдохновляющий 
Instantaneously  - мгновенно 
Instead - вместо 
Insult - оскорблять 
Insurance  - страхование 
Insurgent - повстанцы 
Intact - нетронутый 
Integrity -  честность 
Intelligence agency - спецслужба 
Intent of the all evolution - цель всей эволюции 
Interracial  - межрассовый 
Intimidating  - пугающий 
Into - в
Introduction  - введение 
Intuitively - интуитивно 
Invented - изобретенный 
Invention - изобретение 
Investigating - расследование 
Involves - включает в себя
Issue - проблема 
Issuing - выпуск 
Issuing orders - приказы 
It's been hardened - это повышенной твёрдости 
Ivory - слоновая кость 
Jammed up - застрял 
Jogging - беглый трусцой 
Join - присоединиться 
Judge - судить
Judging  - судить 
Juicer - соковыжималка 
Just such - именно такой 
Just won't flush -  просто не смывается 
Justice - справедливость 
Justification - оправдание 
Keep - держать 
Keep dying - продолжали умирать 
Keeps rising - продолжает расти 
Kick - пинать 
Kidnapping - похищение 
Kin  - родственник
Kind - добрый 
Kind of - вроде 
Kit - набор 
Knees - колени 
Knowing - зная 
Lack - недостаток 
Landing - посадка 
Late again - опять поздно  
Late fees - штрафы за просрочку платежа
Law - закон 
Lay - класть 
Lead - вести 
Lean - наклонять 
Leaning towards - склоняется к 
Least - наименее 
Led - вёл 
Ledger - бухгалтерская книга 
Leeched - пиявка 
Left the compound - покинуть комплекс 
Legitimacy - легитимность 
Less - меньше 
Let off - отпускать 
Letting - сдача 
Liar - лжец 
Lie ravenous - лежать голодным 
Lift - поднимать 
Lighten up - облегчить 
Linear - линейный 
Lingering - затяжной 
Listed - перечислены 
Litany of - перечисления 
Literally - буквально 
Loan - заем 
Lobbying - лоббирование
Loo - туалет 
Look closely - посмотрите внимательно 
Loop - петля 
Loud - громкий 
Loyal - лояльный 
Luggage  - багаж 
Lumbering - неуклюжий 
Maggot - личинка 
Maiming - калечащий 
Maintenance  - обслуживание 
Make a trade - совершить сделку 
Make up the - составляют 
Maketh - делает 
Malice - злоба 
Mammoth - мамонт 
Manpower - рабочая сила 
Manual - руководство 
Marched - маршировал 
Marriage - свадьба 
Match - соответствовать 
Mate - приятель 
Matter - материя 
Meaning- значение 
Meant  - иметь в виду 
Measure - мера 
Medulla - мозговое вещество 
Membership - членство 
Ment to find - хотел найти 
Mental - психический 
Mercenaries - наёмники 
Merchant - торговец 
Merciless - безжалостный 
Merely - просто 
Merge - сливаться 
Meringues - безе
Mess - беспорядок 
Met - встретил 
Midair - в воздухе 
Mill - мельница 
Miracle - чудо 
Misleading - вводящий в заблуждение 
Missed - пропустил 
Molehill - кротовина 
Moosie  - лось 
Mortal - смертный 
Most - большинство 
Mother-in-law - свекровь 
Mountaintop- вершина горы 
Mug - кружка (сленг рожа, морда)
Multiple - несколько 
Multiple torn ligaments - множественные разрывы связок 
Muscle - мышца 
Nails - гвозди 
Naval - военно-морской 
Navy - военно-морской 
Necessary - необходимый
Neck - шея 
Necklace - ожерелье 
Neither - ни один 
Nest - гнездо 
Netherworld - преисподняя 
Network - сеть 
Newcomers - новички 
Nick his car - взломать его машину 
No glory for you - не благодаря тебе 
Nod - кивок 
Node - узел 
Notable - заметный 
Notice - уведомление 
Nurse - медсестра 
Nursing - уход за больными 
Nutshell  - в двух словах 
Oblivion -  забвение 
Observe  - наблюдать 
Obsession  -  одержимость 
Obtain - получать 
Obvious - очевидно 
Occasion - повод 
Occur - происходить 
Odd - странный 
Off the grid - вне сети
Off the hook - сорваться с крючка 
Offends - оскорбляет 
Offense - оскорбление 
Offer - предложение 
Often - часто 
On call - по вызову
On the side - на стороне 
One might - можно было бы 
Onset - начало 
Onto - на 
Operate - действовать 
Opinion - мнение 
Opportunity - возможность 
Opposed - против 
Organ harvest - забор органов 
Other - другой 
Ought - должен 
Ourselves up -  себя 
Out-of-cort - внесудебный 
Outstanding - выдающийся 
Outstayed - просроченный 
Outward - наружу 
Overdue - просроченный 
Overlook - игнорировать 
Overstep - перешагивать
Overthrow - свергнуть 
Owe - быть должным 
Pair  - пара
Papacy - папство 
Paramount - первостепенный 
Parentheses - круглые скобки 
Parlor tricks - дешёвые трюки 
Particular  - особый 
Pass - ввести 
Patch up - заделывать 
Path - путь 
Patience - терпение 
Pea - горох 
Pec - грудная клетка 
Pegged -  привязанный 
Penalty - штраф
Pending - в ожидании 
Penned - записал 
Pep - бодрость духа 
Per - за 
Performing - выполнение 
Perhaps - возможно
Perishes - погибает 
Permissive - снисходительный 
Permit - разрешать 
Petty - мелкий 
Pick - выбирать 
Piece - кусок 
Pillow - подушка 
Pin - игла 
Piss - моча 
Pitch - подача 
Pitcher - кувшин 
Pity - жалость
Plaster - штукатурка 
Pleasure  - удовольствие 
Pleb - плебей 
Plenty - множество 
Plots - участки 
Pocket - карман 
Polishing  - полировка 
Poor - бедный 
Portion - часть 
Possessed  - одержимый 
Possibility - возможность
Possible - возможно 
Posted - опубликовано 
Potential - потенциал 
Poverty - бедность 
Prayer room - молитвенная комната
Preaching - проповедь 
Preceding - предшествующий 
Preferring - предпочитая 
Prematurely - преждевременно 
Premired - премьера 
Premise - помещение 
Prepare - подготовить 
Prepped - подготовленный 
Prerecorded - предварительно записанный 
Preserve - сохранять 
Pretend - притвориться 
Pretty much - довольно много 
Previous - предыдущий 
Prior - прежний 
Probability  - вероятность 
Probably - вероятно 
Processing - обработка 
Produce - производить 
Projectile - снаряд 
Projection - проекция 
Promotion - повышение
Property - свойство (дом, имущество) 
Prophecy - пророчество 
Proposal - предложение
Propose - предлагать 
Protect -  защищать 
Provided - предоставил 
Purpose - цель 
Quest to invade - стремление вторгнуться 
Queue - очередь 
Quite - довольно
Quite - тихий 
Quntized fields - квантовые поля 
Rad - рад 
Raise - поднимать  
Ramps up - нарастает 
Rang - звонил 
Rank - отвратительно 
Ransom - выкуп 
Rapid - стремительный 
Ratchet up the body count - увеличить количество трупов 
Rather -  скорее 
Raves - рейвы 
Razor - бритва 
Reach - достигать
Realize - понимать
Reason - причина 
Reassuring - обнадеживающий 
Reattach - снова прикреплённый 
Rebels - повстанцы 
Receive - получить 
Recently - недавно 
Recklessly - безрассудно 
Recognizable - узнаваемый 
Recognize - узнавать 
Record - записывать 
Reduced - уменьшенный 
Reel - катушка 
Reelection - переизбрание 
Reflect - отражение 
Reforged  - перекован 
Refuse - отказаться 
Regard -  внимание 
Regardless - несмотря ни на что 
Regiment - полк 
Regret - сожалеть 
Regret - сожалеть 
Regrettable - достойный сожаления 
Rehash - перефразировать 
Reject - отклонять 
Relatively  - относительно
Release - выпускать 
Relieved - освободить от чего-то 
Reliving - переживание 
Rely - полагаться 
Remains - останки 
Reminisce  - вспоминать 
Remote  - удалённый 
Rent - арендовать 
Reorient - переориентировать 
Repertoire  - репертуар 
Replace - заменять 
Replacement - замена 
Reported - сообщил 
Repossession - возвращение во владение 
Represent - представлять 
Republic - Республика 
Required  - необходимый 
Requirement - требование 
Rescue - спасать 
Research- исследования 
Reset - перезагрузить 
Residue - остаток 
Respect - уважение 
Resurrected - воскресший 
Retired - ушедший на пенсию 
Retouching  - ретушь 
Reuse - повторное использование 
Revenue - доход 
Reward - награда
Ridiculous  - нелепо 
Rigamarole - вздор 
Right out - сразу 
Rip - рвать 
Rip it off - сорвать это 
Rise - рост
Rival - соперник 
River estuary  - устье реки 
Rollerblade - ролики 
Roman - римский 
Root - корень
Rotted - сгнил 
Rough - грубый 
Route - маршрут 
Royal - королевский 
Rubbery - резиновый 
Rubble - щебень 
Ruffle - рябь 
Ruined - разрушенный 
Ruler - линейка 
Rust - ржавчина 
Sacred - священный 
Sails - паруса 
Sake - ради 
Salaries - зарплата 
Same - такой же
Sanctuary - Святилище 
Sand - песок 
Sat - сидел 
Savage - дикарь 
Scar  - шрам 
Scratch - царапать 
Seasoning - приправа 
Secured - обезопасить 
Seduced - соблазнил 
Seed - семя 
Seek - искать 
Seldom - редко 
Selection - выбрать 
Self-esteem - самооценка 
Sense - смысл 
Senses - чувства 
Sensibility - восприятие 
Separate  - отдельный 
Sequence - последовательность 
Sequentially - последовательно
Set  - набор 
Settle - решить 
Settlement - урегулирование 
Shall - должны 
Shame - стыд 
Shape - форма 
Share - делиться 
Sharing - обмен 
Sharply - резко 
Shatter - разбить 
Shelter - приют 
Shelve - полка 
Shield - щит
Shift - смена 
Shower heads - душевая лейка
Showing off - хвастаться 
Shrank - сжался 
Shrug - пожимание плечами 
Shuffle - перемешивать 
Shutdown - неисправность
Shuttling - челночный
Shuttling numbers - обмена номерами 
Sick - больной 
Significantly  - существенно 
Silly - глупый 
Similar  - похоже 
Similarly  - похожим образом 
Simply - просто 
Simultaneously   - одновременно 
Sin - грех 
Since - с , так как 
Slay - убить
Slit - щель 
Sliver of - кусочек 
Slobbering  - слюнявый 
Slow down- помедленнее, замедлитесь 
Smirks -  ухмыляться 
Smothe - задушить 
Smouldering - тлеющий 
Snag - загвоздка 
Snap - щелчок 
Snapshot - снимок 
Sneaky - подлый 
Snooty - высокомерный 
Snorkels - трубка 
Sob story - печальная история 
Solid -  твёрдый 
Solve - решать 
Soon  - скоро 
Sorcerers - колдуны 
Sorcery - колдовство 
Sorrow - горе
Sorts of way - виды способов 
Spare - запасной 
Spark - искра 
Spatial - пространственный 
Specify - указать 
Speck - пятнышко, пылинка 
Speech - речь
Speechless - безмолвный 
Spell - заклинание 
Spend - тратить 
Spent - потраченный
Spill - проливать 
Spit - плевок 
Splicing - соединение 
Spoke - говорил 
Spoon - ложка 
Spotting - обнаружение 
Spread - распространение 
Spreadsheet - электронная таблица 
Spreed - распространение 
Square - квадрат 
Stakes - ставки 
Stale -  несвежий 
Steadfast - стойкий 
Steam - пар 
Steer - управлять 
Stem - корень
Step to far - зайти слишком далеко 
Stick to - придерживаться 
Still - все ещё
Stolen - украденный 
Stomach - желудок 
Storage - хранилище 
Store - магазин 
Stored - хранится 
Straight - прямой 
Straightforward - простой 
Strain - напряжение
Stream - транслировать 
Strict - строго 
Strike - ударять 
Stripe - полоса 
Struggle -  борьба
Strung up - подвесить 
Stubbornness - упрямство 
Stuff - вещи 
Stumbled - спотыкаться
Stumped - тупик 
Submission - подчинение 
Subtraction  - вычитание 
Such - такую
Sucks - отстой 
Suddenly - внезапно 
Sue for - предъявлять иск 
Suffering - страдания 
Sufficient  - достаточный 
Suffocating -  удушающий 
Suggesting - предложенный 
Suitable - подходящий 
Sulfur - сера 
Summon - вызвать 
Supply - поставлять 
Suppose - предполагать 
Surface - поверхность 
Surgery - операция 
Surrender to its current - сдаться своему настоящему 
Surrounding - окружающий 
Surveil - наблюдение 
Surveillance - наблюдение
Suspicious  - подозрительный 
Sustain - поддерживать 
Swallow - глотать 
Swashbuckle - головорез 
Sweat - пот 
Swelled - опухший 
Swing - качать 
Swing by - пролететь мимо 
Switch - выключатель 
Tab - вкладка 
Tailor - портной 
Taken over - захвачен 
Takeoff -  снимать 
Tampering - подделка 
Tape - лента 
Taxation -  налогообложение 
Tear down - срывать 
Tears - слезы 
Television remote - пульт от телевизора 
Thankful - благодарный 
The cost - цена 
The plane banked - самолёт накренился 
The rest of us - остальные из нас 
Thief - вор
Thieves - воры 
Thing - вещи 
Thorough  - тщательный 
Thought - мысль
Threat - угроза 
Thriving - процветающий 
Throat - горло 
Through - через 
Throw - бросить 
Thrown - брошенный 
Thuse - таким образом 
Tie - галстук 
Tied down - привязанный 
Tight - тугой 
Time is of the essence - время имеет существенное значение 
Tissues - ткани
Together - вместе
Tone - тон 
Tonguing - язык 
Tons - тонн 
Took - взять 
Torn - разорванные 
Toss - бросать 
Toward - к 
Trace - след 
Track - отслеживать 
Trade - торговля
Tramp - бродяга 
Transmitting - передача
Trapped - в ловушке 
Traumatized  - травмированный 
Traversing   - пересекая 
Treatment - уход
Treats - лечит 
Tribute  - дань
Trickle - струйка 
Trim - подрезать 
Troop - отряд 
Truce - перемирие 
Tube  - трубка 
Tumor - опухоль 
Turn - повернуться 
Unable -  не могущий 
Uncharted - неизведанный 
Uncrackable - невзламыыаемый 
Underlie - лежать в основе 
Undermine - подрывать 
Undetected - незамеченный 
Unfair - несправедливы 
Unfortunately - к сожалению 
Uninherited  - ненаследственный 
Union - союз 
Unity - единство 
Unpleasantness - неприятность 
Unpredictable  - непредсказуемый 
Unrelated - несвязанный
Unrest - беспорядки 
Unstable - нестабильный 
Until - до 
Untreatable - неизлечимый 
Unwilling - нежелающий 
Upon - на, по 
Upsetting - расстраивающий 
Upstairs - вверх по лестнице 
Urgent - срочный 
Usefulness - полезность 
Vacation - отпуск 
Valor - доблесть 
Vary - отличаться 
Vast - огромный 
Vehicle - транспортное средство 
Venture - риск 
Vermin - паразит 
Versatile  - универсальный 
Via - с помощью 
Vigilance - бдительность 
Violence - насилие 
Vital - жизненно-важный 
Vowels - гласные
Waitress - официантка 
Wanker  - дрочер 
Ward - сторожить 
Wardrobe - гардероб 
Warehouse - склад 
Warm - тёплый 
Warn - предупреждать 8ки
Warning - предупреждение 
Warrant - ордер 
Waste - напрасно тратить
Waving - размахивая 
We might - мы можем 
We'll close up - мы заканчиваем 
Weak chins - слабые подбородки 
Wealth - богатство 
Weird - странный 
Whatevs - что нибудь 
Wheelchair- инвалидная коляска 
When I'm casing place rob - когда я граблю место 
Which - который 
Whole - весь
Whore - шлюха 
Widen - расширить
Wig - парик 
Will be held - будет проходить 
Willing - готовый 
Wipe  - вытирать 
Wire - проволока 
Wire me my per diem - телеграфируйте мне мои суточные 
Wish - желание 
Withdrew - снял 
Witness - свидетель 
Witty - остроумно 
Wonder - удивляться 
Workflow - рабочий процесс
Worldwide - мировой 
Worry - волноваться 
Worse - худший 
Worst - худший 
Worth - ценность 
Worth it - стоит того
Wrapped - завернутый 
Yardstick - измерительная линейка 
Yelling - кричать 
You kept him alive - ты сохранил ему жизнь 
You know the drill - вы знаете что делать 
You said this one would be hard - вы сказали этот раз будет сложным 
You will shit - вы обосретесь(вы офигеете)
You've got to be messing with me- ты должен возиться со мной 
